B B B B B B B B B B B B B B B B
S S S S S S S S S S S S S S S S
S S S S S S S S S S S S S S S S
B B S S S S S S S S S S S B B B
S S S S S S S S S S S S S S S S
S S S S S S S S S S S S S S S S
B B B S S S S S S S S B B B B B
S S S S S S S S S S S S S S S S
S S S S S S B B B B S S S S S S
S S S S S S S S S S S S S S S S
S S S S S S S S S S S S S S S S
S S S S B B B B B B B B S S S S
1 100
1 270
1 500
2 250
2 360
3 150